0 0 0 0 0 0 0 0 0 0 0 0 0 0 0 0 0 0 0 0 0 0 0 0 0 0 0 0 0 0 0 0 0 0 0 0 0 0 0 0 0 0 0 0 0 0 0 0 0 0 0 0
0 0 0 0 0 0 0 0 0 0 0 0 0 0 0 0 0 0 0 0 0 0 0 0 0 0 0 0 0 0 0 0 0 0 0 0 0 0 0 0 0 0 0 0 0 0 0 0 0 0 0 0
0 0 0 0 0 0 0 0 0 0 0 0 0 0 0 0 0 0 0 0 0 0 0 0 0 0 0 0 0 0 0 0 0 0 0 0 0 0 0 0 0 0 0 0 0 0 0 0 0 0 0 0
0 0 0 0 0 0 0 0 0 0 0 0 0 0 0 0 0 0 0 0 0 0 0 0 0 0 0 0 0 0 0 0 0 0 0 0 0 0 0 0 0 0 0 0 0 0 0 0 0 0 0 0
0 0 0 0 0 0 0 0 0 0 0 0 0 0 0 0 0 0 0 0 0 0 0 0 0 0 0 0 0 0 0 0 0 0 0 0 0 0 0 0 0 0 0 0 0 0 0 0 0 0 0 0
0 0 0 0 0 0 0 0 0 0 0 0 0 0 0 0 0 0 0 0 0 0 0 0 0 0 0 0 0 0 0 0 0 0 0 0 0 0 0 0 0 0 0 0 0 0 0 0 0 0 0 0
0 0 0 0 0 0 0 0 0 0 0 0 0 0 0 0 0 0 0 0 0 0 0 0 0 0 0 0 0 0 0 0 0 0 0 0 0 0 0 0 0 0 0 0 0 0 0 0 0 0 0 0
0 0 0 0 0 0 0 0 0 0 0 0 0 0 0 0 0 0 0 0 0 0 0 0 0 0 0 0 0 0 0 0 0 0 0 0 0 0 0 0 0 0 0 0 0 0 0 0 0 0 0 0
0 0 0 0 0 0 0 0 0 0 0 0 0 0 0 0 0 0 0 0 0 0 0 0 0 0 0 0 0 0 0 0 0 0 0 0 0 0 0 0 0 0 0 0 0 0 0 0 0 0 0 0
0 0 0 0 0 0 0 0 0 0 0 0 0 0 0 0 0 0 0 0 0 0 0 0 0 0 0 0 0 0 0 0 0 0 0 0 0 0 0 0 0 0 0 0 0 0 0 0 0 0 0 0
0 0 0 0 0 0 0 0 0 0 0 0 0 0 0 0 0 0 0 0 0 0 0 0 0 0 0 0 0 0 0 0 0 0 0 0 0 0 0 0 0 0 0 0 0 0 0 0 0 0 0 0
0 0 0 0 0 0 0 0 0 0 0 0 0 0 0 0 0 0 0 0 0 0 0 0 0 0 0 0 0 0 0 0 0 0 0 0 0 0 0 0 0 0 0 0 0 0 0 0 0 0 0 0
0 0 0 0 0 0 0 0 0 0 0 0 0 0 0 0 0 39 39 39 39 39 39 39 39 39 39 39 39 39 39 39 39 39 39 39 39 39 0 0 0 0 0 0 0 0 0 0 0 0 0 0
0 0 0 0 0 0 0 39 39 39 39 39 39 39 39 39 39 39 16 16 16 16 16 16 16 16 16 16 16 16 16 16 16 16 16 16 16 39 39 39 0 0 0 0 0 0 0 0 0 0 0 0
0 0 0 0 0 0 39 39 16 16 16 16 16 16 16 16 16 16 16 2 2 12 10 10 10 10 13 2 2 2 2 2 2 2 2 2 16 16 39 39 0 0 0 0 0 0 0 0 0 0 0 0
0 0 0 0 0 39 39 16 16 16 16 16 16 16 16 16 16 16 2 12 10 11 3 3 3 3 9 13 2 2 2 2 2 2 2 2 2 16 16 39 39 39 39 0 0 0 0 0 0 0 0 0
0 0 0 0 39 39 16 16 16 16 16 2 2 2 2 2 2 12 10 11 3 3 3 4 6 3 3 7 2 2 2 2 2 2 2 2 2 2 2 39 39 39 39 0 0 0 0 0 0 0 0 0
0 0 0 0 39 39 16 16 2 2 2 2 2 2 2 2 12 11 3 3 3 3 4 2 14 5 5 15 20 21 21 21 21 22 2 2 2 2 2 2 2 2 39 39 0 0 0 0 0 0 0 0
0 0 39 39 16 16 2 2 2 2 2 2 2 2 2 12 11 3 3 3 3 4 16 16 16 2 2 2 23 18 18 18 18 24 2 2 2 2 2 2 2 2 2 39 39 0 0 0 0 0 0 0
0 39 54 12 10 10 10 10 10 10 10 10 10 10 10 11 3 3 3 3 4 16 16 16 16 16 2 2 23 18 18 18 18 24 2 2 2 2 2 2 2 2 17 17 39 39 39 0 0 0 0 0
0 39 54 8 3 3 3 3 3 3 3 3 3 3 3 3 3 3 3 3 7 2 2 16 16 16 16 2 25 26 29 18 18 24 2 2 2 2 2 2 17 17 17 17 17 39 39 39 39 0 0 0
0 39 54 14 5 5 5 5 5 5 5 5 5 5 5 6 3 3 3 3 9 10 13 2 16 16 16 2 2 2 23 18 18 30 22 2 2 2 2 17 17 17 17 17 17 54 54 39 39 39 0 0
0 39 54 2 2 2 2 2 2 2 2 2 2 2 2 14 5 5 6 3 3 3 7 2 16 16 2 2 2 34 34 34 34 34 34 34 2 2 17 17 17 17 17 17 49 47 47 47 47 47 0 0
0 39 54 54 54 2 2 2 16 16 16 16 2 2 2 2 2 2 2 6 3 3 7 16 16 16 2 2 2 34 34 34 34 34 34 34 2 2 17 17 17 17 17 17 45 40 40 40 40 40 0 0
0 39 39 39 39 16 2 2 2 2 2 16 16 16 2 2 2 2 2 8 3 3 7 16 16 2 2 2 2 2 2 25 26 26 27 2 2 2 17 17 17 17 17 17 45 40 40 40 40 40 0 0
0 39 39 39 39 16 16 2 2 2 16 16 16 16 16 16 2 2 2 8 3 3 7 2 2 2 2 2 16 16 16 16 2 2 2 2 2 2 17 17 17 17 17 17 51 42 42 42 42 42 0 0
0 0 39 39 39 16 16 16 16 16 16 16 16 16 16 16 16 2 2 14 5 5 15 2 2 2 2 2 2 16 16 16 2 2 2 2 2 2 2 17 17 17 17 17 17 54 54 39 39 39 0 0
0 0 0 39 39 39 39 39 39 39 39 16 16 16 16 16 33 2 2 2 2 2 2 2 2 2 2 2 2 2 16 16 16 16 2 2 2 2 2 17 17 17 17 17 17 54 54 39 39 39 0 0
0 0 0 0 0 0 0 0 0 0 39 39 39 16 16 16 33 33 33 16 16 16 16 16 16 16 2 2 2 2 2 16 16 16 2 2 2 2 2 17 17 17 17 17 17 54 39 39 0 0 0 0
0 0 0 0 0 0 0 0 0 0 0 0 39 39 16 16 16 16 16 16 16 16 39 39 39 16 16 2 2 2 2 2 2 2 2 2 2 2 2 2 2 17 17 17 39 39 39 39 0 0 0 0
0 0 0 0 0 0 0 0 0 0 0 0 0 0 39 16 16 16 39 39 39 39 39 39 39 39 16 16 2 2 2 2 2 2 2 2 16 16 2 2 2 2 39 39 39 0 0 0 0 0 0 0
0 0 0 0 0 0 0 0 0 0 0 0 0 0 39 39 39 39 39 0 0 0 0 0 0 39 39 39 16 16 16 16 16 16 16 16 39 39 39 39 39 39 39 39 0 0 0 0 0 0 0 0
0 0 0 0 0 0 0 0 0 0 0 0 0 0 0 0 0 0 0 0 0 0 0 0 0 0 0 39 39 39 39 39 39 39 39 39 39 39 39 0 0 0 0 0 0 0 0 0 0 0 0 0
0 0 0 0 0 0 0 0 0 0 0 0 0 0 0 0 0 0 0 0 0 0 0 0 0 0 0 0 0 39 39 39 39 39 39 39 0 0 0 0 0 0 0 0 0 0 0 0 0 0 0 0
0 0 0 0 0 0 0 0 0 0 0 0 0 0 0 0 0 0 0 0 0 0 0 0 0 0 0 0 0 0 0 0 0 0 0 0 0 0 0 0 0 0 0 0 0 0 0 0 0 0 0 0
0 0 0 0 0 0 0 0 0 0 0 0 0 0 0 0 0 0 0 0 0 0 0 0 0 0 0 0 0 0 0 0 0 0 0 0 0 0 0 0 0 0 0 0 0 0 0 0 0 0 0 0
0 0 0 0 0 0 0 0 0 0 0 0 0 0 0 0 0 0 0 0 0 0 0 0 0 0 0 0 0 0 0 0 0 0 0 0 0 0 0 0 0 0 0 0 0 0 0 0 0 0 0 0
0 0 0 0 0 0 0 0 0 0 0 0 0 0 0 0 0 0 0 0 0 0 0 0 0 0 0 0 0 0 0 0 0 0 0 0 0 0 0 0 0 0 0 0 0 0 0 0 0 0 0 0
0 0 0 0 0 0 0 0 0 0 0 0 0 0 0 0 0 0 0 0 0 0 0 0 0 0 0 0 0 0 0 0 0 0 0 0 0 0 0 0 0 0 0 0 0 0 0 0 0 0 0 0
0 0 0 0 0 0 0 0 0 0 0 0 0 0 0 0 0 0 0 0 0 0 0 0 0 0 0 0 0 0 0 0 0 0 0 0 0 0 0 0 0 0 0 0 0 0 0 0 0 0 0 0
0 0 0 0 0 0 0 0 0 0 0 0 0 0 0 0 0 0 0 0 0 0 0 0 0 0 0 0 0 0 0 0 0 0 0 0 0 0 0 0 0 0 0 0 0 0 0 0 0 0 0 0
0 0 0 0 0 0 0 0 0 0 0 0 0 0 0 0 0 0 0 0 0 0 0 0 0 0 0 0 0 0 0 0 0 0 0 0 0 0 0 0 0 0 0 0 0 0 0 0 0 0 0 0
0 0 0 0 0 0 0 0 0 0 0 0 0 0 0 0 0 0 0 0 0 0 0 0 0 0 0 0 0 0 0 0 0 0 0 0 0 0 0 0 0 0 0 0 0 0 0 0 0 0 0 0
0 0 0 0 0 0 0 0 0 0 0 0 0 0 0 0 0 0 0 0 0 0 0 0 0 0 0 0 0 0 0 0 0 0 0 0 0 0 0 0 0 0 0 0 0 0 0 0 0 0 0 0
0 0 0 0 0 0 0 0 0 0 0 0 0 0 0 0 0 0 0 0 0 0 0 0 0 0 0 0 0 0 0 0 0 0 0 0 0 0 0 0 0 0 0 0 0 0 0 0 0 0 0 0
0 0 0 0 0 0 0 0 0 0 0 0 0 0 0 0 0 0 0 0 0 0 0 0 0 0 0 0 0 0 0 0 0 0 0 0 0 0 0 0 0 0 0 0 0 0 0 0 0 0 0 0
0 0 0 0 0 0 0 0 0 0 0 0 0 0 0 0 0 0 0 0 0 0 0 0 0 0 0 0 0 0 0 0 0 0 0 0 0 0 0 0 0 0 0 0 0 0 0 0 0 0 0 0
0 0 0 0 0 0 0 0 0 0 0 0 0 0 0 0 0 0 0 0 0 0 0 0 0 0 0 0 0 0 0 0 0 0 0 0 0 0 0 0 0 0 0 0 0 0 0 0 0 0 0 0
0 0 0 0 0 0 0 0 0 0 0 0 0 0 0 0 0 0 0 0 0 0 0 0 0 0 0 0 0 0 0 0 0 0 0 0 0 0 0 0 0 0 0 0 0 0 0 0 0 0 0 0
0 0 0 0 0 0 0 0 0 0 0 0 0 0 0 0 0 0 0 0 0 0 0 0 0 0 0 0 0 0 0 0 0 0 0 0 0 0 0 0 0 0 0 0 0 0 0 0 0 0 0 0
