0 0 0 0 0 0 0 0 0 0 0 0 0 0 0 0 0 0 0 0 0 0 0 0 0 0 0 0 0 0 0 0 0 0 0 0 0 0 0 0 0 0 0 0 0 0 0 0 0 0 
0 0 0 0 0 0 0 0 0 0 0 0 0 0 0 0 0 0 0 0 0 0 0 0 0 0 0 0 0 0 0 0 0 0 0 0 0 0 0 0 0 0 0 0 0 0 0 0 0 0 
0 0 0 0 0 0 0 0 0 0 0 0 0 0 0 0 0 0 0 0 0 0 0 0 0 0 0 0 0 0 0 0 0 0 0 0 0 0 0 0 0 0 0 0 0 0 0 0 0 0 
0 0 0 0 0 0 0 0 0 0 0 0 0 0 0 0 0 39 39 39 39 39 39 39 39 39 39 39 39 39 39 39 39 39 39 0 0 0 0 0 0 0 0 0 0 0 0 0 0 0 
0 0 0 0 0 0 0 0 0 0 0 0 0 0 39 39 39 39 17 17 17 17 17 17 17 17 17 17 17 17 17 17 39 39 39 39 39 0 0 0 0 0 0 0 0 0 0 0 0 0 
0 0 0 0 0 0 0 0 0 0 0 0 0 39 17 17 38 17 17 16 16 16 16 16 16 16 16 16 16 16 16 16 17 17 17 17 39 39 39 0 0 0 0 0 0 0 0 0 0 0 
0 0 0 0 0 0 0 0 0 0 0 39 39 17 17 16 16 16 16 20 21 21 21 21 21 21 21 21 21 21 21 21 22 16 16 17 17 17 39 39 39 0 0 0 0 0 0 0 0 0 
0 0 0 0 0 0 0 0 0 39 39 39 17 17 16 16 16 16 16 23 18 18 18 18 18 19 19 18 18 18 18 18 30 22 16 16 16 17 17 17 39 39 39 0 0 0 0 0 0 0 
0 0 0 0 0 0 0 0 0 39 38 17 17 16 20 21 21 21 21 31 18 4 5 5 5 5 5 6 18 19 19 19 18 30 21 22 16 16 16 17 17 17 39 39 0 0 0 0 0 0 
0 0 0 0 0 0 0 0 39 39 17 17 16 16 23 18 18 18 18 18 4 15 16 16 16 16 16 14 5 5 5 5 6 18 18 30 22 16 16 16 17 17 17 39 39 0 0 0 0 0 
0 0 0 0 0 0 0 39 39 17 17 16 20 21 31 18 4 5 5 5 15 16 16 1 1 1 16 16 16 16 16 16 14 6 18 18 30 22 16 16 16 17 17 17 39 39 39 0 0 0 
0 0 0 0 0 0 0 39 39 17 16 16 23 18 18 4 15 16 16 16 16 16 2 1 33 33 33 2 1 33 1 16 16 14 6 18 18 30 22 1 16 16 17 17 17 39 39 39 0 0 
0 0 0 0 0 0 0 39 17 16 16 1 23 18 18 7 16 16 1 2 2 2 2 2 2 2 2 2 33 33 33 1 16 16 14 6 18 18 30 22 1 16 16 16 17 17 17 39 39 39 
0 0 0 0 0 0 39 39 17 16 1 1 23 19 18 7 16 1 2 33 33 2 2 2 35 2 2 2 2 2 2 2 2 1 16 14 5 6 18 24 1 16 16 16 16 17 17 17 17 17 
0 0 0 0 0 39 39 17 16 16 1 1 23 19 18 7 16 2 2 33 33 2 35 2 2 2 2 2 2 35 1 33 33 2 16 16 16 8 18 24 1 16 16 16 16 16 17 17 17 17 
0 0 0 0 39 39 17 17 16 16 1 1 23 19 19 7 16 16 1 2 2 2 2 1 2 2 2 2 2 2 2 33 33 2 2 2 16 8 19 24 1 16 16 16 16 16 16 16 16 16 
0 0 0 0 39 39 17 16 16 1 1 1 23 18 19 9 13 16 16 16 16 16 16 1 1 2 2 34 34 2 2 2 2 2 1 16 16 8 19 24 1 16 16 16 16 16 16 16 16 16 
0 0 0 39 39 17 17 1 1 1 2 2 25 26 18 18 9 10 10 10 10 13 16 16 16 12 10 34 34 10 10 13 16 16 16 16 1 11 18 24 1 16 16 16 16 16 16 16 16 16 
0 0 0 39 39 12 10 10 13 1 1 2 1 1 25 26 26 29 18 18 18 9 10 10 10 11 18 34 34 18 18 9 10 10 10 10 11 18 18 27 1 16 16 16 16 16 16 16 16 16 
0 0 39 39 39 11 3 3 9 10 10 10 13 1 1 1 1 25 26 26 29 18 19 19 18 18 18 34 34 18 18 18 18 19 19 18 18 18 27 1 1 32 32 32 32 32 32 16 16 16 
0 0 39 39 3 3 3 3 3 3 3 3 9 13 1 1 1 1 1 2 25 26 26 26 26 26 26 34 34 26 26 26 26 26 26 26 26 27 1 2 2 40 40 40 40 40 32 32 32 16 
0 0 39 3 3 3 3 3 3 3 3 3 3 9 10 13 1 1 1 2 1 1 1 1 1 12 11 34 34 9 13 1 1 1 1 1 1 1 1 2 10 10 10 10 13 40 40 32 32 32 
0 39 4 5 5 5 5 5 5 6 3 3 3 3 3 9 10 13 1 1 1 2 1 2 1 14 6 34 34 4 15 2 2 2 2 2 12 10 10 11 3 3 3 3 9 10 13 40 32 32 
0 39 7 1 16 16 16 16 1 14 6 3 3 3 3 3 3 9 10 10 10 13 1 2 2 1 8 7 8 7 1 12 10 10 10 10 11 3 3 3 3 3 3 3 3 3 9 10 10 32 
0 39 9 1 16 16 16 16 16 2 14 5 5 6 3 3 3 3 3 3 3 9 10 10 10 10 11 7 8 9 10 11 3 3 3 3 3 3 4 5 5 5 5 5 5 5 5 5 5 17 
0 39 39 9 13 1 2 1 16 16 2 2 2 8 3 3 3 3 3 3 3 3 3 3 3 3 3 7 8 3 3 3 4 5 5 5 5 5 15 1 16 16 16 2 1 2 2 1 65 17 
0 39 39 39 7 1 1 1 1 2 2 1 1 14 5 5 5 5 5 5 5 5 5 5 5 5 5 15 14 5 5 5 15 1 1 2 2 2 1 2 2 2 2 2 2 2 1 1 65 17 
0 0 39 39 7 1 1 1 1 1 1 1 1 1 1 1 1 1 1 1 1 1 1 1 1 1 1 1 1 1 2 2 2 1 1 1 1 1 2 2 1 2 2 12 10 10 10 13 65 17 
0 0 39 39 7 1 1 1 1 1 1 1 1 2 2 2 2 1 1 2 2 1 1 1 2 1 1 2 1 1 1 1 1 1 1 1 1 1 1 1 1 10 10 11 3 4 6 9 10 17 
0 39 39 39 7 2 1 1 1 1 1 2 2 1 12 10 10 10 10 10 13 2 1 1 2 2 1 1 1 1 1 1 2 2 1 1 1 1 1 12 11 3 3 3 4 15 40 40 40 32 
0 39 39 4 15 2 1 1 1 1 1 2 1 10 11 3 3 3 3 3 9 2 2 12 10 13 2 2 1 1 1 1 1 1 1 2 2 2 12 11 3 4 5 5 15 40 40 40 32 32 
0 39 39 7 16 16 16 2 1 1 2 2 11 3 3 3 3 3 3 3 3 7 2 8 3 9 10 10 10 1 1 1 2 2 2 2 1 1 11 3 4 1 40 40 40 40 32 32 32 32 
0 39 39 7 16 16 16 16 16 2 1 11 3 3 3 3 3 3 3 3 3 7 1 8 3 3 3 3 3 9 10 10 10 13 16 16 12 11 3 4 1 1 40 40 32 32 32 32 17 17 
0 0 39 9 10 10 10 10 10 10 11 3 3 3 3 3 4 5 5 5 5 15 2 8 3 3 3 3 3 3 3 3 3 9 10 10 11 3 4 1 2 1 32 32 32 32 17 17 17 17 
0 0 39 39 39 17 17 3 3 3 3 3 3 4 5 5 15 2 2 1 1 2 1 14 5 5 6 3 3 3 3 3 3 3 3 3 3 3 7 2 2 1 1 1 1 17 17 17 39 39 
0 0 39 39 39 39 17 17 16 16 16 16 16 2 2 1 2 1 2 2 2 2 2 2 1 1 33 5 5 5 5 6 3 3 3 3 3 3 7 2 1 1 1 17 17 17 39 39 39 39 
0 0 0 0 39 39 39 17 17 17 17 16 16 16 2 2 1 33 1 2 2 2 2 1 1 1 1 1 1 1 16 14 5 5 5 5 5 5 15 16 16 16 17 17 17 39 39 0 0 0 
0 0 0 0 39 39 39 39 39 17 17 17 16 16 32 2 16 1 2 2 33 20 21 21 21 21 21 22 1 16 16 16 32 32 1 1 16 16 16 16 17 17 17 17 39 39 0 0 0 0 
0 0 0 0 0 0 0 39 39 39 39 17 17 17 32 32 16 16 16 16 1 23 19 19 18 19 18 24 16 16 16 32 32 16 16 16 16 16 16 17 17 17 39 39 39 0 0 0 0 0 
0 0 0 0 0 0 0 0 39 39 39 39 39 17 17 32 32 32 16 16 16 25 26 26 26 26 26 27 16 16 32 32 16 16 16 16 16 17 17 17 17 39 39 39 0 0 0 0 0 0 
0 0 0 0 0 0 0 0 0 39 39 39 39 39 39 39 39 32 32 16 16 16 1 1 1 1 1 16 16 32 32 16 16 16 17 17 17 17 17 39 39 39 39 0 0 0 0 0 0 0 
0 0 0 0 0 0 0 0 0 0 0 39 39 0 39 39 39 39 32 32 32 32 32 32 32 32 1 16 32 32 16 16 16 17 17 17 17 39 39 39 39 39 0 0 0 0 0 0 0 0 
0 0 0 0 0 0 0 0 0 0 0 0 0 0 0 39 39 39 39 39 39 39 39 39 39 32 32 32 32 17 17 17 17 17 17 39 39 39 39 39 39 0 0 0 0 0 0 0 0 0 
0 0 0 0 0 0 0 0 0 0 0 0 0 0 0 0 0 39 39 39 39 39 39 39 39 39 39 39 39 39 39 39 39 39 39 39 39 39 0 0 0 0 0 0 0 0 0 0 0 0 
0 0 0 0 0 0 0 0 0 0 0 0 0 0 0 0 0 0 0 0 0 0 0 0 0 0 0 0 0 0 0 0 0 0 0 0 0 0 0 0 0 0 0 0 0 0 0 0 0 0 
0 0 0 0 0 0 0 0 0 0 0 0 0 0 0 0 0 0 0 0 0 0 0 0 0 0 0 0 0 0 0 0 0 0 0 0 0 0 0 0 0 0 0 0 0 0 0 0 0 0 
0 0 0 0 0 0 0 0 0 0 0 0 0 0 0 0 0 0 0 0 0 0 0 0 0 0 0 0 0 0 0 0 0 0 0 0 0 0 0 0 0 0 0 0 0 0 0 0 0 0 
0 0 0 0 0 0 0 0 0 0 0 0 0 0 0 0 0 0 0 0 0 0 0 0 0 0 0 0 0 0 0 0 0 0 0 0 0 0 0 0 0 0 0 0 0 0 0 0 0 0 
0 0 0 0 0 0 0 0 0 0 0 0 0 0 0 0 0 0 0 0 0 0 0 0 0 0 0 0 0 0 0 0 0 0 0 0 0 0 0 0 0 0 0 0 0 0 0 0 0 0 
0 0 0 0 0 0 0 0 0 0 0 0 0 0 0 0 0 0 0 0 0 0 0 0 0 0 0 0 0 0 0 0 0 0 0 0 0 0 0 0 0 0 0 0 0 0 0 0 0 0 
