0 0 0 0 0 0 0 0 0 0 0 0 0 0 0 0 0 0 0 0 0 0 0 0 0 0 0 0 0 0 0 0 0 0 0 0 0 0 0 0 0 0 0 0 0 0 0 0 0 0 
0 0 0 0 0 0 0 0 0 0 0 0 0 0 0 0 0 0 0 0 0 0 0 0 0 0 0 0 0 0 0 0 0 0 0 0 0 0 0 0 0 0 0 0 0 0 0 0 0 0 
0 0 0 0 0 0 0 0 0 0 0 0 0 0 0 0 0 0 0 0 0 0 0 0 0 0 0 0 0 0 0 0 0 0 0 0 0 0 0 0 0 0 0 0 0 0 0 0 0 0 
0 0 0 0 0 0 0 0 0 0 0 0 0 0 0 0 0 0 0 0 0 0 0 0 0 0 0 0 0 0 0 0 0 0 0 0 0 0 0 0 0 0 0 0 0 0 0 0 0 0 
0 0 0 0 0 0 0 0 0 0 0 0 0 0 0 0 0 0 0 0 0 0 0 0 0 0 0 0 0 0 0 0 0 0 0 0 0 0 0 0 0 0 0 0 0 0 0 0 0 0 
0 0 0 0 0 0 0 0 0 0 0 0 0 0 0 0 0 0 0 0 0 0 0 0 0 0 0 0 0 0 0 0 0 0 0 0 0 0 0 0 0 0 0 0 0 0 0 0 0 0 
0 0 0 0 0 0 0 0 0 0 0 0 0 0 0 0 0 0 0 0 0 0 0 0 0 0 0 0 0 0 0 0 0 0 0 0 0 0 0 0 0 0 0 0 0 0 0 0 0 0 
0 0 0 0 0 0 0 0 0 0 0 0 0 0 0 0 0 0 0 0 0 0 0 0 0 0 0 0 0 0 0 0 0 0 0 0 0 0 0 0 0 0 0 0 0 0 0 0 0 0 
0 0 0 0 0 0 0 0 0 0 0 0 0 0 0 0 0 0 0 0 0 0 0 0 0 0 0 0 0 0 0 0 0 0 0 0 0 0 0 0 0 0 0 0 0 0 0 0 0 0 
0 0 0 0 0 0 0 0 0 0 0 0 0 0 0 0 0 0 0 0 0 0 0 68 68 68 68 68 68 0 0 0 0 0 0 0 0 0 0 0 0 0 0 0 0 0 0 0 0 0
0 0 0 0 0 0 0 0 0 0 0 0 0 0 0 0 0 0 0 0 0 0 0 68 66 66 66 66 68 0 0 0 0 0 0 0 0 0 0 0 0 0 0 0 0 0 0 0 0 0
0 0 0 0 0 0 0 0 0 0 0 0 0 0 0 0 0 0 0 0 0 0 0 68 66 70 70 66 68 0 0 0 0 0 0 0 0 0 0 0 0 0 0 0 0 0 0 0 0 0
0 0 0 0 0 0 0 0 0 0 0 0 0 0 0 0 0 0 0 0 0 0 0 68 66 70 70 66 68 0 0 0 0 0 0 0 0 0 0 0 0 0 0 0 0 0 0 0 0 0
0 0 0 0 0 0 0 0 0 0 0 0 0 0 68 68 68 68 68 68 68 68 68 68 66 70 70 66 68 68 68 68 0 68 68 68 0 0 0 0 0 0 0 0 0 0 0 0 0 0
0 0 0 0 0 0 0 0 0 0 0 0 0 68 68 68 68 68 68 68 68 68 68 68 66 70 70 66 68 68 68 68 68 68 68 68 68 68 0 0 0 0 0 0 0 0 0 0 0 0
0 0 0 0 0 0 0 0 0 0 70 70 68 68 70 70 70 66 66 66 66 66 66 66 66 70 70 66 66 66 66 66 66 66 66 70 68 68 0 0 0 0 0 0 0 0 0 0 0 0
0 0 0 0 0 0 0 0 0 0 68 68 68 70 70 66 66 66 70 70 68 70 70 70 70 70 70 70 70 70 70 70 70 70 66 66 70 68 68 68 68 0 0 0 0 0 0 0 0 0
0 0 0 0 0 0 0 0 0 68 68 70 70 66 66 66 70 70 70 70 70 70 70 70 70 70 70 70 70 70 70 70 70 70 70 66 66 70 68 68 68 0 0 0 0 0 0 0 0 0 
0 0 0 0 0 0 0 0 0 68 68 66 66 66 68 70 70 70 70 70 70 70 70 70 70 70 70 70 70 70 70 70 70 70 70 68 68 66 66 68 68 68 68 0 0 0 0 0 0 0 
0 0 0 0 0 0 0 0 0 68 68 66 70 70 70 70 70 70 70 70 70 70 70 70 70 70 70 70 70 70 70 70 70 70 70 70 70 70 66 66 68 68 68 0 0 0 0 0 0 0 
0 0 0 0 0 0 0 0 0 68 66 70 70 70 70 70 70 70 70 70 70 70 17 17 17 17 17 17 17 17 70 70 70 70 70 70 70 70 70 66 66 68 68 0 0 0 0 0 0 0 
0 0 0 0 0 0 0 0 0 68 66 70 70 70 70 70 70 70 70 70 70 70 17 17 17 17 17 17 17 17 70 70 70 70 70 70 70 70 70 70 66 66 68 68 0 0 0 0 0 0 
0 0 0 0 0 0 0 0 0 68 66 68 70 70 70 70 70 70 70 70 70 70 17 17 17 17 17 17 17 17 70 70 70 70 70 70 70 70 70 70 70 66 68 0 0 0 0 0 0 0 
0 0 0 0 0 0 0 0 0 68 66 70 70 70 70 70 70 70 70 70 70 70 17 17 17 17 17 17 17 17 70 70 70 70 70 70 70 70 70 70 68 66 68 0 0 0 0 0 0 0 
0 0 0 0 0 0 0 0 0 68 66 70 70 70 70 70 70 70 70 70 70 70 17 17 17 17 17 17 17 17 70 70 70 70 70 70 70 70 70 70 70 66 68 0 0 0 0 0 0 0 
0 0 0 0 0 0 0 0 0 68 66 70 70 70 70 70 70 70 70 70 70 70 17 17 17 17 17 17 17 17 70 70 70 70 70 70 70 70 70 70 70 66 68 0 0 0 0 0 0 0 
0 0 0 0 0 0 0 0 0 68 66 70 70 70 70 70 70 70 70 70 70 70 17 17 17 17 17 17 17 17 70 70 70 70 70 70 70 70 70 70 70 66 68 0 0 0 0 0 0 0 
0 0 0 0 0 0 0 0 0 68 66 70 70 70 70 70 70 70 70 70 70 70 17 17 17 17 17 17 17 17 70 70 70 70 70 70 70 70 70 70 70 66 68 0 0 0 0 0 0 0 
0 0 0 0 0 0 0 0 0 68 66 70 70 70 70 70 70 70 70 70 70 70 70 70 70 70 70 70 70 70 70 70 70 70 70 70 70 70 70 70 68 66 68 0 0 0 0 0 0 0 
0 0 0 0 0 0 0 0 0 68 68 66 68 70 70 70 70 70 70 70 70 70 70 70 70 70 70 70 70 70 70 70 70 70 70 70 70 70 70 66 66 66 68 0 0 0 0 0 0 0 
0 0 0 0 0 0 0 0 0 0 68 68 66 66 70 70 70 70 70 70 70 70 70 70 70 70 70 70 70 70 70 70 70 70 70 70 70 70 66 66 70 68 68 0 0 0 0 0 0 0 
0 0 0 0 0 0 0 0 0 0 70 68 68 66 66 70 70 68 68 70 70 70 70 70 68 70 70 70 70 70 70 70 70 68 70 70 70 66 66 70 68 68 0 0 0 0 0 0 0 0 
0 0 0 0 0 0 0 0 0 0 70 70 68 68 66 66 66 66 66 66 66 66 66 66 66 66 66 66 66 66 66 66 66 66 66 66 66 66 70 68 68 70 0 0 0 0 0 0 0 0 
0 0 0 0 0 0 0 0 0 0 0 0 0 68 68 68 68 68 68 68 68 68 68 68 68 68 68 68 68 68 68 68 68 68 68 68 68 68 68 68 0 0 0 0 0 0 0 0 0 0 
0 0 0 0 0 0 0 0 0 0 0 0 0 0 0 0 0 0 0 0 0 0 0 0 0 0 0 0 68 68 68 68 68 68 68 68 68 0 0 0 0 0 0 0 0 0 0 0 0 0 
0 0 0 0 0 0 0 0 0 0 0 0 0 0 0 0 0 0 0 0 0 0 0 0 0 0 0 0 0 0 0 0 0 0 0 0 0 0 0 0 0 0 0 0 0 0 0 0 0 0 
0 0 0 0 0 0 0 0 0 0 0 0 0 0 0 0 0 0 0 0 0 0 0 0 0 0 0 0 0 0 0 0 0 0 0 0 0 0 0 0 0 0 0 0 0 0 0 0 0 0 
0 0 0 0 0 0 0 0 0 0 0 0 0 0 0 0 0 0 0 0 0 0 0 0 0 0 0 0 0 0 0 0 0 0 0 0 0 0 0 0 0 0 0 0 0 0 0 0 0 0 
0 0 0 0 0 0 0 0 0 0 0 0 0 0 0 0 0 0 0 0 0 0 0 0 0 0 0 0 0 0 0 0 0 0 0 0 0 0 0 0 0 0 0 0 0 0 0 0 0 0 
0 0 0 0 0 0 0 0 0 0 0 0 0 0 0 0 0 0 0 0 0 0 0 0 0 0 0 0 0 0 0 0 0 0 0 0 0 0 0 0 0 0 0 0 0 0 0 0 0 0 
0 0 0 0 0 0 0 0 0 0 0 0 0 0 0 0 0 0 0 0 0 0 0 0 0 0 0 0 0 0 0 0 0 0 0 0 0 0 0 0 0 0 0 0 0 0 0 0 0 0 
0 0 0 0 0 0 0 0 0 0 0 0 0 0 0 0 0 0 0 0 0 0 0 0 0 0 0 0 0 0 0 0 0 0 0 0 0 0 0 0 0 0 0 0 0 0 0 0 0 0 
0 0 0 0 0 0 0 0 0 0 0 0 0 0 0 0 0 0 0 0 0 0 0 0 0 0 0 0 0 0 0 0 0 0 0 0 0 0 0 0 0 0 0 0 0 0 0 0 0 0 
0 0 0 0 0 0 0 0 0 0 0 0 0 0 0 0 0 0 0 0 0 0 0 0 0 0 0 0 0 0 0 0 0 0 0 0 0 0 0 0 0 0 0 0 0 0 0 0 0 0 
0 0 0 0 0 0 0 0 0 0 0 0 0 0 0 0 0 0 0 0 0 0 0 0 0 0 0 0 0 0 0 0 0 0 0 0 0 0 0 0 0 0 0 0 0 0 0 0 0 0 
0 0 0 0 0 0 0 0 0 0 0 0 0 0 0 0 0 0 0 0 0 0 0 0 0 0 0 0 0 0 0 0 0 0 0 0 0 0 0 0 0 0 0 0 0 0 0 0 0 0 
0 0 0 0 0 0 0 0 0 0 0 0 0 0 0 0 0 0 0 0 0 0 0 0 0 0 0 0 0 0 0 0 0 0 0 0 0 0 0 0 0 0 0 0 0 0 0 0 0 0 
0 0 0 0 0 0 0 0 0 0 0 0 0 0 0 0 0 0 0 0 0 0 0 0 0 0 0 0 0 0 0 0 0 0 0 0 0 0 0 0 0 0 0 0 0 0 0 0 0 0 
0 0 0 0 0 0 0 0 0 0 0 0 0 0 0 0 0 0 0 0 0 0 0 0 0 0 0 0 0 0 0 0 0 0 0 0 0 0 0 0 0 0 0 0 0 0 0 0 0 0 
0 0 0 0 0 0 0 0 0 0 0 0 0 0 0 0 0 0 0 0 0 0 0 0 0 0 0 0 0 0 0 0 0 0 0 0 0 0 0 0 0 0 0 0 0 0 0 0 0 0 
