67 67 67 67 67 67 67 67 67 67 67 67 67 67 67 67 67 67 67 67 67 67 67 67 67 67 67 67 67 67 67 67 67 67 67 67 67 67 67 67 66 66 66 66 66 66 66 66 66 66
67 67 67 67 67 67 67 67 67 67 67 67 67 67 67 67 67 67 67 67 67 67 67 67 67 67 67 67 67 67 67 67 67 67 67 67 67 67 67 67 67 67 67 67 67 67 67 67 67 67
67 67 67 67 67 67 67 67 67 67 67 67 67 67 67 67 67 67 67 67 67 67 67 67 67 67 67 67 67 67 67 67 67 67 67 67 67 67 67 67 67 67 67 67 67 67 67 67 67 67
67 67 67 67 67 67 67 67 67 67 67 67 67 67 67 67 67 67 67 67 67 67 67 67 67 67 67 67 67 67 67 67 67 67 67 67 67 67 67 67 67 67 67 67 67 67 67 67 67 67
67 67 67 67 67 67 67 67 67 67 67 67 67 67 67 67 67 67 67 67 67 67 67 67 67 67 67 67 67 67 67 67 67 67 67 67 67 67 67 67 67 67 67 67 67 67 67 67 67 67
67 67 67 67 67 67 67 67 67 67 67 67 67 67 67 67 67 67 67 67 67 67 67 67 67 67 67 67 67 67 67 67 67 67 67 67 67 67 67 67 67 67 67 67 67 67 67 67 67 67
67 67 67 67 67 67 67 67 67 67 67 67 67 67 67 67 67 67 67 67 67 67 67 67 67 67 67 67 67 67 67 67 67 67 67 67 67 67 67 67 67 67 67 67 67 67 67 67 67 67
67 67 67 67 67 67 67 67 67 67 67 67 67 67 67 67 67 67 67 67 67 67 67 67 67 67 67 67 67 67 67 67 67 67 67 67 67 67 67 67 67 67 67 67 67 67 67 67 67 67
67 67 67 67 67 67 67 67 67 67 67 67 67 67 67 67 67 67 67 67 67 67 67 67 67 67 67 67 67 67 67 67 67 67 67 67 67 67 67 67 67 67 67 67 67 67 67 67 67 67
66 66 66 66 66 66 66 66 66 66 66 66 66 66 66 66 66 66 66 66 66 66 66 66 66 66 66 66 66 66 66 66 66 66 66 66 66 66 67 67 67 67 67 67 67 67 67 67 67 67
66 66 66 66 66 66 66 66 66 66 66 66 66 66 66 66 66 66 66 66 66 66 66 66 66 66 66 66 66 66 66 66 66 66 66 66 66 66 66 66 66 66 66 66 66 66 66 66 66 66
66 66 66 66 66 66 66 66 66 66 66 66 66 66 66 66 66 66 66 66 66 66 66 66 66 66 66 66 66 66 66 66 66 66 66 66 66 66 66 66 66 66 66 66 66 66 66 66 66 66
66 66 66 66 66 66 66 66 66 66 66 66 66 66 66 66 66 66 66 66 66 66 66 66 66 66 66 66 66 66 66 66 66 66 66 66 66 66 66 66 66 66 66 66 66 66 66 66 66 66
66 66 66 66 66 66 66 66 66 66 66 66 66 66 66 66 66 66 66 66 66 66 66 66 66 66 66 66 66 66 66 66 66 66 66 66 66 66 66 66 66 66 66 66 66 66 66 66 66 66
66 66 66 66 66 66 66 66 66 66 66 66 66 66 66 66 66 66 66 66 66 66 66 66 66 66 66 66 66 66 66 66 66 66 69 69 69 66 66 66 66 66 66 66 66 66 66 66 66 66
66 66 66 66 66 66 66 66 66 66 66 66 66 66 66 66 66 66 66 66 66 66 66 66 66 66 66 66 66 66 66 66 66 66 69 66 66 66 66 66 66 66 66 66 66 66 66 66 66 66
66 66 66 66 66 66 66 66 66 66 66 66 66 66 66 66 66 66 66 66 66 66 66 66 66 66 66 69 66 66 66 66 66 69 66 66 66 66 66 66 66 66 66 66 66 66 66 66 66 66
66 66 66 66 66 66 66 69 69 69 69 69 69 69 69 69 69 69 69 69 69 69 69 69 69 69 69 69 69 69 69 69 69 69 66 69 69 69 69 69 69 69 69 66 69 66 69 69 69 69
66 66 66 66 66 66 66 69 69 69 69 69 69 69 69 69 69 69 69 69 69 69 69 69 69 69 69 69 69 69 69 69 69 69 69 69 69 69 69 69 69 69 69 69 69 66 69 69 69 17
66 66 66 66 66 66 66 66 66 66 66 69 69 66 66 69 69 69 69 69 69 69 66 69 66 66 66 66 66 66 66 66 66 66 66 66 66 66 66 66 66 17 17 66 66 66 66 66 17 69
66 66 66 66 66 66 66 66 69 69 66 66 66 66 69 69 69 69 69 66 69 69 69 69 66 66 66 66 66 66 66 66 66 66 66 66 66 66 66 17 17 17 17 17 17 66 69 17 17 17
66 66 66 66 66 66 66 69 69 69 66 66 66 66 69 69 69 66 66 69 69 69 66 66 66 66 66 66 66 66 66 66 66 66 66 66 66 17 17 17 17 17 17 17 17 17 69 69 17 17
66 66 66 66 66 66 66 69 66 66 66 66 66 66 66 69 66 66 69 69 69 66 66 69 66 66 66 66 66 66 66 66 66 66 66 66 17 17 17 17 17 17 17 69 17 69 17 17 17 17
66 66 66 66 66 66 66 69 66 66 69 69 66 66 66 66 66 69 66 66 66 66 66 66 66 66 66 66 66 66 66 66 17 17 17 17 17 17 69 69 69 69 69 17 17 17 66 69 69 69
66 66 66 66 66 66 66 69 69 69 66 66 66 69 66 69 66 66 66 66 66 66 66 69 66 66 66 66 66 17 17 17 17 17 17 17 69 69 69 69 69 69 69 69 69 69 69 69 69 69
66 66 66 66 66 66 66 66 69 69 66 66 66 66 66 66 66 66 66 66 69 69 66 66 66 66 66 66 17 17 17 17 17 17 17 17 17 69 69 69 69 69 66 69 69 69 66 69 69 69
66 66 66 66 66 66 66 66 69 69 66 66 69 66 66 66 66 69 66 66 66 66 66 66 66 66 66 17 17 17 17 69 69 17 17 17 69 69 69 69 69 66 66 69 69 69 69 69 69 69
66 66 66 66 66 66 66 66 69 66 66 66 66 66 66 66 66 66 66 66 66 66 66 66 17 17 17 17 17 17 69 69 69 69 69 69 69 69 69 69 69 69 69 69 69 69 69 69 69 69
66 66 66 66 66 66 66 66 66 69 69 66 66 66 66 66 66 66 66 66 66 66 66 17 17 17 17 17 17 69 69 69 69 69 69 69 69 69 69 69 69 69 69 69 69 69 69 69 69 69
66 66 66 66 66 66 66 69 69 69 69 69 66 66 66 66 66 66 66 66 66 66 17 17 17 17 17 69 69 69 69 69 69 69 69 69 69 69 69 69 69 69 69 69 69 69 69 69 69 69
66 66 66 66 66 66 66 69 69 66 69 69 66 66 66 66 66 66 66 66 17 17 17 17 17 69 69 69 69 69 69 69 69 69 69 69 69 69 69 69 69 69 69 69 69 69 69 69 69 69
66 66 66 66 66 66 66 66 69 66 66 66 66 66 66 66 66 66 66 17 17 17 17 17 69 69 69 69 69 69 69 69 69 69 69 69 69 69 69 69 69 69 69 69 69 69 69 69 69 69
66 66 66 66 66 66 66 66 69 66 66 66 66 66 66 66 17 66 17 17 17 69 69 69 69 69 69 69 69 69 69 69 69 69 69 69 69 69 69 69 69 69 69 69 69 69 69 69 69 69
66 66 66 66 66 66 66 69 69 66 66 66 66 66 17 17 17 17 17 69 69 69 69 69 69 69 69 69 69 69 69 69 69 69 69 69 69 69 69 69 69 69 69 69 69 69 69 69 69 69
66 66 66 66 66 66 66 69 66 66 66 66 66 66 17 17 17 17 69 69 69 69 69 69 69 69 69 69 69 69 69 69 69 69 69 69 69 69 69 69 69 69 69 69 69 69 69 69 69 69
66 66 66 66 66 66 66 66 66 66 66 66 17 17 17 17 69 69 69 69 69 69 69 69 69 69 69 69 69 69 69 69 69 69 69 69 69 69 69 69 69 69 69 69 69 69 69 69 69 69
66 66 66 66 66 66 66 66 66 66 66 17 17 17 17 69 69 69 69 69 69 69 69 69 69 69 69 69 69 69 69 69 69 69 69 69 69 69 69 69 69 69 69 69 69 69 69 69 69 69
66 66 66 66 66 66 66 66 66 66 17 17 17 69 69 69 69 69 69 69 69 69 69 69 69 69 69 69 69 69 69 69 69 69 69 69 69 69 69 69 69 69 69 69 69 69 69 69 69 69
66 66 66 66 66 66 66 66 66 66 17 17 69 69 69 69 69 69 69 69 69 69 69 69 69 69 69 69 69 69 69 69 69 69 69 69 69 69 69 69 69 69 69 69 69 69 69 69 69 69
66 66 66 66 66 66 66 66 66 17 17 17 17 69 69 69 69 69 69 69 69 69 69 69 69 69 69 69 69 69 69 69 69 69 69 69 69 69 69 69 69 69 69 69 69 69 69 69 69 69
66 66 66 66 66 66 66 66 66 66 17 17 17 17 69 69 69 69 69 69 69 69 69 69 69 69 69 69 69 69 69 69 69 69 69 69 69 69 69 69 69 69 69 69 69 69 69 69 69 69
66 66 66 66 66 66 66 17 17 17 17 17 17 17 69 69 69 69 69 69 69 69 69 69 69 69 69 69 69 69 69 69 69 69 69 69 69 69 69 69 69 69 69 69 69 69 69 69 69 69
66 66 66 66 66 66 66 69 69 17 17 17 17 17 69 69 69 69 69 69 69 69 69 69 69 69 69 69 69 69 69 69 69 69 69 69 69 69 69 69 69 69 69 69 69 69 69 69 69 69
66 66 66 66 66 66 66 66 66 69 17 17 17 17 69 69 69 69 69 69 69 69 69 69 69 69 69 69 69 69 69 69 69 69 69 69 69 69 69 69 69 69 69 69 69 69 69 69 69 69
66 66 66 66 66 66 66 69 69 66 66 66 17 17 69 69 69 69 69 69 69 69 69 69 69 69 69 69 69 69 69 69 69 69 69 69 69 69 69 69 69 69 69 69 69 69 69 69 69 69
66 66 66 66 66 66 66 66 66 69 66 66 17 17 17 69 69 69 69 69 69 69 69 69 69 69 69 69 69 69 69 69 69 69 69 69 69 69 69 69 69 69 69 69 69 69 69 69 69 69
66 66 66 66 66 66 66 66 66 66 66 69 66 17 17 69 69 69 69 69 69 69 69 69 69 69 69 69 69 69 69 69 69 69 69 69 69 69 69 69 69 69 69 69 69 69 69 69 69 69
66 66 66 66 66 66 66 66 66 66 66 66 66 17 17 17 69 69 69 69 69 69 69 69 69 69 69 69 69 69 69 69 69 69 69 69 69 69 69 69 69 69 69 69 69 69 69 69 69 69
66 66 66 66 66 66 66 69 66 66 66 66 66 66 17 17 69 69 69 69 69 69 69 69 69 69 69 69 69 69 69 69 69 69 69 69 69 69 69 69 69 69 69 69 69 69 69 69 69 69
66 66 66 66 66 66 66 69 69 66 66 66 66 69 17 17 69 69 69 69 69 69 69 69 69 69 69 69 69 69 69 69 69 69 69 69 69 69 69 69 69 69 69 69 69 69 69 69 69 69