0 0 0 0 0 0 0 0 0 0 0 0 0 0 0 0 0 0 0 0 0 0 0 0 0 0 0 0 0 0 0 0 0 0 0 0 0 0 0 0 0 0 0 0 0 0 0 0 0 0 
0 0 0 0 0 0 0 0 0 0 0 0 0 0 0 0 0 0 0 0 0 0 0 0 0 0 0 0 0 0 0 0 0 0 0 0 0 0 0 0 0 0 0 0 0 0 0 0 0 0 
0 0 0 0 0 0 0 0 0 0 0 0 0 0 0 0 0 0 0 0 0 0 0 0 0 0 0 0 0 0 0 0 0 0 0 0 0 0 0 0 0 0 0 0 0 0 0 0 0 0 
0 0 0 0 0 0 0 0 0 0 0 0 0 0 0 0 0 0 0 0 0 0 0 0 0 0 0 0 0 0 0 0 0 0 0 0 0 0 0 0 0 0 0 0 0 0 0 0 0 0 
0 0 0 0 0 0 0 0 0 0 0 0 0 0 0 0 0 0 0 0 0 0 0 0 0 0 0 0 0 0 0 0 0 0 0 0 0 0 0 0 0 0 0 0 0 0 0 0 0 0 
0 0 0 0 0 0 0 0 0 0 0 0 0 0 0 0 0 0 0 0 0 0 0 0 0 0 0 0 0 0 0 0 0 0 0 0 0 0 0 0 0 0 0 0 0 0 0 0 0 0 
0 0 0 0 0 0 0 0 0 0 0 0 0 0 0 0 0 0 0 0 0 0 0 0 0 0 0 0 0 0 0 0 0 0 0 0 0 0 0 0 0 0 0 0 0 0 0 0 0 0 
0 0 0 0 0 0 0 0 0 0 0 0 0 0 0 0 0 0 0 0 0 0 0 0 0 0 0 0 0 0 0 0 0 0 0 0 0 0 0 0 0 0 0 0 0 0 0 0 0 0 
0 0 0 0 0 0 0 0 0 0 0 0 0 0 0 0 0 0 0 0 0 0 0 0 0 0 0 0 0 0 0 0 0 0 0 0 0 0 0 0 0 0 0 0 0 0 0 0 0 0 
0 0 0 0 0 0 0 0 0 0 0 0 0 0 0 0 0 0 0 0 0 0 0 0 0 0 0 0 0 0 0 0 0 0 0 0 0 0 0 0 0 0 0 0 0 0 0 0 0 0 
0 0 0 0 0 0 0 0 0 0 0 0 0 0 0 0 0 0 0 0 0 0 0 0 0 0 0 0 0 0 0 0 0 0 0 0 0 0 0 0 0 0 0 0 0 0 0 0 0 0 
0 0 0 0 0 0 0 0 0 0 0 0 0 0 0 0 0 0 0 0 0 0 0 0 0 0 0 0 0 0 0 0 0 0 0 0 0 0 0 0 0 0 0 0 0 0 0 0 0 0 
0 0 0 0 0 0 0 0 0 0 0 0 0 0 0 0 0 0 0 0 0 0 0 0 0 0 0 39 39 39 39 39 39 0 0 0 0 0 0 0 0 0 0 0 0 0 0 0 0 0 
0 0 0 0 0 0 0 0 0 0 0 0 0 0 0 0 0 0 0 0 0 39 39 39 39 39 39 39 53 53 53 53 39 39 39 39 39 0 0 0 0 0 0 0 0 0 0 0 0 0 
0 0 0 0 0 0 0 0 0 0 0 0 0 0 0 0 0 0 0 39 39 39 39 40 41 52 53 53 53 53 53 53 53 53 53 1 39 39 39 39 0 0 0 0 0 0 0 0 0 0 
0 0 0 0 0 0 0 0 0 0 0 0 0 0 0 0 0 39 39 39 40 40 40 40 44 53 53 53 53 53 53 53 1 1 1 3 1 1 1 39 39 0 0 0 0 0 0 0 0 0 
0 0 0 0 0 0 0 0 0 0 0 0 39 39 39 39 39 39 40 40 40 40 40 40 44 53 53 53 53 1 1 3 3 1 3 3 3 1 1 1 39 39 0 0 0 0 0 0 0 0 
0 0 0 0 0 0 0 39 39 39 39 39 39 17 40 40 40 40 40 40 41 42 42 42 52 53 53 1 3 3 3 3 3 3 3 3 3 3 3 1 1 39 39 39 0 0 0 0 0 0 
0 0 0 0 0 0 39 39 17 17 17 17 40 40 41 42 43 40 40 40 44 53 53 53 53 53 1 16 16 1 1 3 3 3 3 3 3 1 1 1 1 39 39 39 39 39 0 0 0 0 
0 0 0 0 0 39 39 17 17 40 40 40 40 40 44 53 45 40 41 42 52 53 53 1 1 16 16 16 1 3 3 3 3 3 3 3 1 1 39 39 39 32 54 54 39 39 39 0 0 0 
0 0 0 0 39 39 17 17 17 40 40 40 41 42 52 53 53 42 52 53 53 53 1 1 16 16 1 1 3 3 3 3 3 3 3 3 1 1 39 32 32 32 54 54 54 39 39 39 0 0 
0 0 0 0 39 17 17 17 40 40 40 41 52 53 53 53 53 53 53 53 1 1 1 16 16 16 1 3 3 3 3 3 1 1 1 1 1 39 39 32 54 54 54 54 54 54 54 39 0 0 
0 0 0 39 39 17 17 17 40 40 40 44 53 53 53 53 53 1 1 1 1 1 16 16 1 1 3 3 3 3 1 1 1 1 1 1 39 39 32 32 54 54 54 54 54 54 54 39 39 0 
0 0 39 39 17 17 17 40 40 40 40 44 53 53 53 53 33 16 16 1 1 1 3 3 3 3 3 3 3 1 1 1 1 1 16 39 39 32 32 54 54 54 54 54 54 54 54 54 39 39 
0 39 39 17 17 17 40 40 41 42 42 52 53 1 1 1 1 33 1 33 1 3 3 3 3 3 3 3 1 1 1 1 1 1 16 1 54 54 54 54 54 54 54 54 32 55 55 55 55 55 
0 39 17 17 17 40 40 40 44 53 53 53 1 1 1 1 1 1 2 1 3 3 3 3 2 2 1 1 1 1 1 1 1 1 1 54 54 54 54 54 54 54 54 54 32 56 56 56 56 56 
0 39 17 17 17 40 40 40 44 53 53 53 1 1 3 3 3 3 3 3 3 3 3 2 2 1 1 1 1 1 1 1 1 1 1 1 1 54 54 54 54 54 54 54 32 65 65 64 64 64 
0 39 17 17 40 41 42 42 52 53 1 1 1 3 3 3 3 3 3 3 3 3 2 2 1 1 1 1 1 1 1 1 3 1 1 1 39 32 32 32 54 54 54 54 54 54 54 54 54 54 
0 39 39 17 40 44 53 53 53 53 1 1 1 1 1 1 1 3 3 3 3 1 2 1 1 1 1 1 3 3 3 3 3 1 1 1 39 39 39 32 54 54 54 54 54 54 54 54 54 54 
0 0 39 39 40 44 53 53 53 1 1 20 22 1 16 16 1 1 1 3 3 1 1 1 1 1 16 1 1 3 1 1 1 1 1 2 1 1 39 32 32 54 54 54 54 54 54 54 54 54 
0 0 39 39 40 44 53 53 1 1 16 23 30 21 21 21 22 1 1 3 3 1 2 2 1 1 16 16 1 1 1 1 3 3 3 2 2 1 39 39 32 32 54 54 53 54 54 54 54 39 
0 0 39 39 40 44 53 53 1 20 21 31 19 18 18 18 24 1 1 3 1 1 1 2 16 1 16 1 1 1 1 1 1 1 3 3 2 1 1 39 39 32 54 54 54 54 54 54 39 39 
0 0 39 39 40 44 53 1 1 23 19 18 18 18 19 19 24 1 1 3 1 1 1 1 16 16 16 1 16 1 1 16 1 1 1 3 3 2 1 1 39 39 39 39 39 39 39 39 39 0 
0 0 0 39 53 53 53 1 16 25 26 26 29 18 19 28 27 1 3 3 1 16 1 1 2 2 1 16 16 1 16 16 16 1 1 3 3 3 3 3 3 1 39 39 0 0 0 0 0 0 
0 0 0 39 53 53 53 53 1 1 1 1 25 26 26 27 1 1 3 16 1 16 16 1 1 1 1 1 16 16 16 16 1 1 3 3 3 3 3 3 3 3 39 0 0 0 0 0 0 0 
0 0 0 39 53 53 53 53 53 1 1 1 16 1 1 1 1 3 3 16 1 1 1 1 1 1 1 16 16 16 1 1 1 3 3 3 3 3 3 1 1 39 39 0 0 0 0 0 0 0 
0 0 0 39 53 53 53 53 53 53 53 53 53 1 1 3 3 3 3 16 16 3 3 3 3 3 3 1 1 1 1 1 1 1 1 1 3 3 1 1 39 39 0 0 0 0 0 0 0 0 
0 0 0 39 39 53 53 53 53 53 53 53 1 16 3 3 1 1 3 1 3 1 3 2 2 2 3 3 3 3 3 3 3 1 1 3 3 1 1 1 39 0 0 0 0 0 0 0 0 0 
0 0 0 0 39 53 53 53 53 53 1 1 1 16 3 1 1 1 1 3 3 1 3 3 3 3 2 1 3 3 3 1 1 1 3 3 1 1 1 1 39 0 0 0 0 0 0 0 0 0 
0 0 0 0 39 53 53 53 53 1 1 33 1 1 3 1 1 16 16 1 1 1 1 1 1 39 1 1 1 1 1 1 1 1 1 1 1 1 1 1 39 0 0 0 0 0 0 0 0 0 
0 0 0 0 39 39 53 1 1 1 16 16 3 3 3 3 33 1 1 1 1 1 1 39 39 39 39 1 1 39 39 39 1 1 1 1 1 1 1 39 39 0 0 0 0 0 0 0 0 0 
0 0 0 0 0 39 53 53 1 33 1 3 3 33 1 33 1 1 1 1 1 39 39 39 39 0 39 39 39 39 0 39 39 39 1 1 1 1 1 39 39 0 0 0 0 0 0 0 0 0 
0 0 0 0 0 0 39 53 1 1 1 1 33 1 16 1 1 1 1 39 39 0 0 0 0 0 0 0 0 0 0 0 0 39 39 39 39 1 1 39 0 0 0 0 0 0 0 0 0 0 
0 0 0 0 0 0 39 53 1 1 33 1 1 1 1 1 1 39 39 39 39 0 0 0 0 0 0 0 0 0 0 0 0 0 0 0 39 39 39 39 0 0 0 0 0 0 0 0 0 0 
0 0 0 0 0 0 39 53 53 1 1 1 1 39 39 39 39 39 39 39 0 0 0 0 0 0 0 0 0 0 0 0 0 0 0 0 0 0 0 0 0 0 0 0 0 0 0 0 0 0 
0 0 0 0 0 0 39 39 53 53 1 39 39 39 0 0 0 0 0 0 0 0 0 0 0 0 0 0 0 0 0 0 0 0 0 0 0 0 0 0 0 0 0 0 0 0 0 0 0 0 
0 0 0 0 0 0 0 39 39 53 39 0 0 0 0 0 0 0 0 0 0 0 0 0 0 0 0 0 0 0 0 0 0 0 0 0 0 0 0 0 0 0 0 0 0 0 0 0 0 0 
0 0 0 0 0 0 0 0 39 39 0 0 0 0 0 0 0 0 0 0 0 0 0 0 0 0 0 0 0 0 0 0 0 0 0 0 0 0 0 0 0 0 0 0 0 0 0 0 0 0 
0 0 0 0 0 0 0 0 0 0 0 0 0 0 0 0 0 0 0 0 0 0 0 0 0 0 0 0 0 0 0 0 0 0 0 0 0 0 0 0 0 0 0 0 0 0 0 0 0 0 
0 0 0 0 0 0 0 0 0 0 0 0 0 0 0 0 0 0 0 0 0 0 0 0 0 0 0 0 0 0 0 0 0 0 0 0 0 0 0 0 0 0 0 0 0 0 0 0 0 0 
