0 0 0 0 0 0 0 0 0 0 0 0 0 0 0 0 0 0 0 0 0 0 0 0 0 0 0 0 0 0 0 0 0 0 0 0 0 0 0 0 0 0 0 0 0 0 0 0 0 0 0
0 0 0 0 0 0 0 0 0 0 0 0 0 0 0 0 0 0 0 0 0 0 0 0 0 0 0 0 0 0 0 0 0 0 0 0 0 0 0 0 0 0 0 0 0 0 0 0 0 0 0
0 0 0 0 0 0 0 0 0 0 0 0 0 0 0 0 0 0 0 0 0 0 0 0 0 0 0 0 0 0 0 0 0 0 0 0 0 0 0 0 0 0 0 0 0 0 0 0 0 0 0
0 0 0 0 0 0 0 0 0 0 0 0 0 0 0 0 0 0 0 0 0 0 0 0 0 0 0 0 0 0 0 0 0 0 0 0 0 0 0 0 0 0 0 0 0 0 0 0 0 0 0
0 0 0 0 0 0 0 0 0 0 0 0 0 0 0 0 0 0 0 0 0 0 0 0 0 0 0 0 0 0 0 0 0 0 0 0 0 0 0 0 0 0 0 0 0 0 0 0 0 0 0
0 0 0 0 0 0 0 0 0 0 0 0 0 0 0 0 0 0 0 0 0 0 0 0 0 0 0 0 0 0 0 0 0 0 0 0 0 0 0 0 0 0 0 0 0 0 0 0 0 0 0
0 0 0 0 0 0 0 0 0 0 0 0 0 0 0 0 0 0 0 0 0 0 0 0 0 0 0 0 0 0 0 0 0 0 0 0 0 0 0 0 0 0 0 0 0 0 0 0 0 0 0
0 0 0 0 0 0 0 0 0 0 0 0 0 0 0 0 0 0 0 0 0 0 0 0 0 0 0 0 0 0 0 0 0 0 0 0 0 0 0 0 0 0 0 0 0 0 0 0 0 0 0
0 0 0 0 0 0 0 0 0 0 0 0 0 0 0 0 0 0 0 0 0 0 0 0 0 0 0 0 0 0 0 0 0 0 0 0 0 0 0 0 0 0 0 0 0 0 0 0 0 0 0
0 0 0 0 0 0 0 0 0 0 0 0 0 0 0 0 0 0 0 0 0 0 0 0 0 0 0 0 0 0 0 0 0 0 0 0 0 0 0 0 0 0 0 0 0 0 0 0 0 0 0
0 0 0 0 0 0 0 0 0 0 0 0 0 0 0 0 0 0 0 0 0 0 0 0 0 0 0 0 0 0 0 0 0 0 0 0 0 0 0 0 0 0 0 0 0 0 0 0 0 0 0
0 0 0 0 0 0 0 0 0 0 0 0 0 0 0 0 0 0 0 0 0 0 0 0 0 0 0 0 0 0 0 0 0 0 0 0 0 0 0 0 0 0 0 0 0 0 0 0 0 0 0
0 0 0 0 0 0 0 0 0 0 0 0 0 0 0 0 0 0 0 0 0 0 0 0 0 0 0 0 0 0 0 0 0 0 0 0 0 0 0 0 0 0 0 0 0 0 0 0 0 0 0
0 0 0 0 0 0 0 0 0 0 0 0 0 0 0 0 0 0 0 0 0 0 0 0 0 0 0 0 0 0 0 0 0 0 0 0 0 0 0 0 0 0 0 0 0 0 0 0 0 0 0
0 0 0 0 0 0 0 0 0 0 0 0 0 0 0 0 0 0 0 0 0 0 0 0 0 0 0 0 0 0 0 0 0 0 0 0 0 0 0 0 0 0 0 0 0 0 0 0 0 0 0
0 0 0 0 0 0 0 0 0 0 0 0 0 0 0 0 0 39 39 39 39 39 39 39 39 39 39 39 39 39 39 39 39 39 39 39 39 0 0 0 0 0 0 0 0 0 0 0 0 0 0
0 0 0 0 0 0 0 0 0 0 0 0 39 39 39 39 39 39 39 39 39 39 39 39 39 39 39 39 39 39 39 3 1 1 39 39 39 39 39 0 0 0 0 0 0 0 0 0 0 0 0
0 0 0 0 0 0 0 39 39 39 39 39 17 17 17 17 17 17 39 39 39 39 39 39 3 3 3 3 3 3 3 3 1 1 1 1 1 1 39 39 39 39 39 39 0 0 0 0 0 0 0
0 0 0 0 0 0 39 39 17 17 17 17 17 17 17 17 17 17 17 17 17 3 3 3 3 1 1 1 1 1 1 1 1 1 1 1 1 1 1 1 39 39 39 39 39 39 0 0 0 0 0
0 0 0 0 0 39 17 17 17 17 1 17 17 17 17 17 3 3 3 3 3 3 3 1 1 1 1 1 1 1 1 1 1 1 1 1 1 1 39 39 39 32 54 54 39 39 39 0 0 0 0
0 0 0 0 39 17 17 17 1 17 1 1 1 1 1 1 1 1 1 1 1 1 1 1 1 1 16 1 1 16 1 16 1 16 1 1 1 1 39 32 32 32 54 54 54 39 39 39 0 0 0
0 0 0 0 39 17 1 1 1 1 1 1 1 1 1 1 1 1 1 1 1 1 1 1 1 1 16 1 1 1 1 1 1 1 1 1 1 39 39 32 54 54 54 54 54 54 54 39 0 0 0
0 0 0 39 39 1 1 1 1 1 1 1 2 2 2 2 1 1 1 1 1 1 1 1 1 1 1 1 33 16 33 16 16 16 1 1 39 39 32 32 54 54 54 54 54 54 54 39 39 0 0
0 0 39 39 1 1 1 17 17 1 1 1 1 1 1 1 2 2 1 1 1 1 3 3 3 1 16 1 33 1 1 1 1 16 16 39 39 32 32 54 54 54 54 54 54 54 54 54 39 39 0
0 0 39 1 1 1 17 17 17 17 1 1 2 20 21 21 21 22 1 1 1 3 3 3 3 3 1 1 1 1 33 16 1 1 16 1 54 54 54 54 54 54 54 54 32 55 55 55 55 55 0
0 39 40 40 1 1 1 17 17 17 1 1 2 23 18 18 18 24 1 1 3 3 3 3 2 2 1 1 33 1 1 16 1 1 1 54 54 54 54 54 54 54 54 54 32 56 56 56 56 56 0
0 39 40 1 1 1 1 1 1 3 1 1 2 23 18 18 18 27 1 1 3 3 3 2 2 1 16 1 1 16 1 1 1 1 1 1 1 54 54 54 54 54 54 54 32 65 65 64 64 39 0
0 39 40 1 1 1 1 1 1 3 1 2 1 25 26 26 27 14 1 3 3 3 2 2 1 1 1 1 1 1 1 1 3 1 1 1 39 32 32 32 54 54 54 54 54 54 54 54 39 39 0
0 39 39 2 2 1 1 1 1 1 3 2 1 1 1 1 1 1 1 3 3 3 2 1 1 1 1 1 3 3 3 3 3 1 1 1 39 39 39 32 54 54 54 54 54 54 54 54 54 39 0
0 0 39 39 2 2 2 2 1 1 1 1 1 3 3 3 3 3 3 3 3 3 1 1 1 1 16 1 1 3 1 1 1 1 1 2 1 1 39 32 32 54 54 54 54 54 54 54 54 39 0
0 0 0 39 1 1 1 1 2 2 1 1 1 1 1 1 3 3 3 3 3 3 2 2 1 1 16 16 1 1 1 1 3 3 3 2 2 1 39 39 32 32 54 54 53 54 54 54 54 39 0
0 0 0 39 1 1 1 2 2 1 1 1 1 1 16 1 16 1 1 1 1 1 1 2 1 1 1 16 1 1 1 1 1 1 3 3 2 1 1 39 39 32 54 54 54 54 54 54 39 39 0
0 0 0 39 39 1 1 1 16 1 1 16 16 1 1 1 1 16 1 16 16 1 1 1 1 1 1 16 16 1 1 16 1 1 1 1 1 2 1 1 39 39 39 39 39 39 39 39 39 0 0
0 0 0 0 39 39 1 1 16 1 1 16 1 1 33 1 1 1 33 1 16 1 1 1 2 2 1 16 16 1 16 16 16 1 1 1 1 1 39 39 39 39 39 39 0 0 0 0 0 0 0
0 0 0 0 0 39 39 1 1 16 16 16 33 16 1 1 33 1 1 16 16 1 16 1 1 1 1 1 16 16 16 16 1 1 39 39 39 39 39 0 0 0 0 0 0 0 0 0 0 0 0
0 0 0 0 0 0 39 39 39 1 16 1 1 16 16 16 1 16 1 16 1 16 1 1 1 1 1 16 16 16 1 1 39 39 39 0 0 0 0 0 0 0 0 0 0 0 0 0 0 0 0
0 0 0 0 0 0 0 0 0 39 39 39 39 39 39 39 3 3 1 16 16 3 3 3 3 3 1 1 1 1 39 39 39 0 0 0 0 0 0 0 0 0 0 0 0 0 0 0 0 0 0
0 0 0 0 0 0 0 0 0 0 0 0 0 0 0 39 39 39 39 39 39 39 3 2 2 2 1 1 1 39 39 0 0 0 0 0 0 0 0 0 0 0 0 0 0 0 0 0 0 0 0
0 0 0 0 0 0 0 0 0 0 0 0 0 0 0 0 0 0 0 39 39 39 3 3 3 3 2 1 39 39 0 0 0 0 0 0 0 0 0 0 0 0 0 0 0 0 0 0 0 0 0
0 0 0 0 0 0 0 0 0 0 0 0 0 0 0 0 0 0 0 0 0 39 39 39 39 3 39 39 39 0 0 0 0 0 0 0 0 0 0 0 0 0 0 0 0 0 0 0 0 0 0
0 0 0 0 0 0 0 0 0 0 0 0 0 0 0 0 0 0 0 0 0 0 0 0 39 39 39 0 0 0 0 0 0 0 0 0 0 0 0 0 0 0 0 0 0 0 0 0 0 0 0
0 0 0 0 0 0 0 0 0 0 0 0 0 0 0 0 0 0 0 0 0 0 0 0 0 0 0 0 0 0 0 0 0 0 0 0 0 0 0 0 0 0 0 0 0 0 0 0 0 0 0
0 0 0 0 0 0 0 0 0 0 0 0 0 0 0 0 0 0 0 0 0 0 0 0 0 0 0 0 0 0 0 0 0 0 0 0 0 0 0 0 0 0 0 0 0 0 0 0 0 0 0
0 0 0 0 0 0 0 0 0 0 0 0 0 0 0 0 0 0 0 0 0 0 0 0 0 0 0 0 0 0 0 0 0 0 0 0 0 0 0 0 0 0 0 0 0 0 0 0 0 0 0
0 0 0 0 0 0 0 0 0 0 0 0 0 0 0 0 0 0 0 0 0 0 0 0 0 0 0 0 0 0 0 0 0 0 0 0 0 0 0 0 0 0 0 0 0 0 0 0 0 0 0
0 0 0 0 0 0 0 0 0 0 0 0 0 0 0 0 0 0 0 0 0 0 0 0 0 0 0 0 0 0 0 0 0 0 0 0 0 0 0 0 0 0 0 0 0 0 0 0 0 0 0
0 0 0 0 0 0 0 0 0 0 0 0 0 0 0 0 0 0 0 0 0 0 0 0 0 0 0 0 0 0 0 0 0 0 0 0 0 0 0 0 0 0 0 0 0 0 0 0 0 0 0
0 0 0 0 0 0 0 0 0 0 0 0 0 0 0 0 0 0 0 0 0 0 0 0 0 0 0 0 0 0 0 0 0 0 0 0 0 0 0 0 0 0 0 0 0 0 0 0 0 0 0
0 0 0 0 0 0 0 0 0 0 0 0 0 0 0 0 0 0 0 0 0 0 0 0 0 0 0 0 0 0 0 0 0 0 0 0 0 0 0 0 0 0 0 0 0 0 0 0 0 0 0
0 0 0 0 0 0 0 0 0 0 0 0 0 0 0 0 0 0 0 0 0 0 0 0 0 0 0 0 0 0 0 0 0 0 0 0 0 0 0 0 0 0 0 0 0 0 0 0 0 0 0
